000000000200000000000000000020000000000000000000000200000000000000000000000000000000000000000000000000
002220000000002000000222000000000000220000002200000022220000022000020000000000000000022000000220000002
002220000000000000000222000000000000000000000000000022000000000000020000000000000000000000000000000002
000000000000000200000000000000000000002000000000000000002000000000000000222200220000000200000000000000
000000000000000020000000000000000000000200000000000000000200000000000000222200222220000020000000000000
000000000000002220000000000000000002222200020000000000222200200000000000222200220200022220002000000000
002222002200002220000222200220000002222200020000022220222200200000200000000000000000222220002000002002
002222002222202220000222200222220002222200022000022220222200220000200000000000000000222220002200002002
002222002202002222000222200220200002222220020000022220222200200000200000222222222200222222002000002002
000000000000002222000000000000000000000000000000000000000000000000000002222222222220200000000000000000
000000000000002220000000000000000000000000000000000000000000000000000000000200000200200000000000000000
002222222222002220000222222222200222222200000000000000222200000000000000000000020000022220000000000002
022222222222202220002222222222220222222220002200220000222200022002200000002202000000022222000220022022
000002000002002220000000200000200200000200002200222220000200022002200000222222000200000020000220022000
000000000200002220000000000020000000020000002200220200020000022002200200222222000000002000000220022000
000022020000002220000002202000000202000000000000000000000000000000000222222222200000000000000000000000
002222220002002220000222222000200222000200000000000000000200000000000222222222200000200020000000000002
002222220000002220200222222000000222000000202222222200000002022222220222222222220000200000020222222002
022222222000002222222222222200000222200000222222222220200002222222220000222000000000220000022222222022
022222222000002222222222222200000222200000220200000200200002202000020000222000000000220000022020000022
022222222200002222222222222220000222220000220000020000220002200000200000000000000000222000022000002022
002220000000002000000222000000000000000000002202000000000000022020020000000000000000000000000220200002
002220000000000000000222000000000000000000002222000200000000022220020000000000000000000000000222200002
000002000002002220000000200000200200000200002222000000000200022220020000222200220000000020000222200000
000000000200002220000000000020000000020000002222200000020000022222020000222200222220002000000222220000
000022020000002220000002202000000202000000002222200000000000022222020000222200220200000000000222220000
002222220002002220000222222000200002222200022222220000222200222222220000000000000020022220002222222002
002222220000002220200222222000000002222200022000000000222200220000000000000000000002022220002200000002
022222222000002222222222222200000002222220022000000000222200220000000000000000022222022222002200000022
022202222220002222222222220222000222222222222022222222222222220222202200220000002222222222222202222022
022202222220000000200000200222000000020000020020000020020000200200002200222220002222202000002002000022
002200222220000000000020000222000000000002000000002000000020000000002200220200002222200000200000000002
002200222220000002202000000222000000220200000020200000220200000202000000000000000000022020000002020002
002200222220000222222000200222000022222200020022200020222200200222000000000000000000022220002002220002
002200222220200222222000000222020022222200000022200000222200000222002222222200222222222220000002220002
002200222222222222222200000222222222222220000022220000222200000222202222222220222222222222000002222002
002200222222222222222200000222222222222220000022220000222200000222200200000200200000222222000002222002
002200222222222222222220000222222222222222000022222000222220000222200000020000000020022222200002222002
000200022000000222000000000200000022200000000000000000200000000000002202000000202000020000000000000000
000000000000000222000000000000000022200000000000000000200000000000002222000200222000220000000000000000
022202222220000000200000200222000000020000020020000020020000200200002222000000222000002000002002000022
002200222220000000000020000222000000000002000000002000000020000000002222200000222200000000200000000002
002200222220000002202000000222000000220200000020200000220200000202002222200000222200022020000002020002
002200222220000222222000200222000022222200020000222220222200200002202222220000222220022220002000022002
002200222220200222222000000222020022222200000000222220222200000002202000000000000000022220000000022002
002200222222222222222200000222222222222220000000222222222200000002202000000000000000022222000000022002
002200222222222222222200000222222222222220000000222222222200000002200022222222220000022222000000022002
002200222222222222222220000222222222222222000000222222222220000002200022222222222000022222200000022002
000200022000000222000000000200000022200000000000022000200000000000200000022200000000020000000000002000
000000000000000222000000000000000022200000000000000000200000000000000000022200000000020000000000000000
000000000200000000000000000020000000000000000000000200000000000000000000000000000000000000000000000000
000000000020000000000000000002000000000000000000000020000000000000000000000000000000000000000000000000
002200222220000000000000000222000000000000000000222220000000000002200000000000000000000000000000022002
002200222220000222200220000222000022220022000000222220220020000002200000022220022000022002200000022002
002200222220000222200220000222000022220022000000222220220020000002200000022220022000022002200000022002
002200222220000222200222220222000022220022222000222220220022220002202000022220022222022002222200022002
002200222222000222200220200222200022220022020000222222220020200002200000022220022020022002202000022002
002200222222000000000000000222200000000000000000222222000000000002200000000000000000000000000000022002
002200222220000000000000000222000000000000000000222220000000000002200000000000000000000000000000022002
002200222220000222222222200222000022222222220000222220222222200002200000022222222220022222222000022002
000002000002002220000000200000200200000200002222000000000200022220020000222200220000000020000222200000
000000000200002220000000000020000000020000002222200000020000022222020000222200222220002000000222220000
000022020000002220000002202000000202000000002222200000000000022222020000222200220200000000000222220000
000022020000002220000002202000000202000000002222200000000000022222020000222200220200000000000222220000
002222220002002220000222222000200002222200022222220000222200222222220000000000000020022220002222222002
002222220000002220200222222000000002222200022000000000222200220000000000000000000002022220002200000002
022222222000002222222222222200000002222220022000000000222200220000000000000000022222022222002200000022
022202222220002222222222220222000222222222222022222222222222220222202200220000002222222222222202222022
022202222220000000200000200222000000020000020020000020020000200200002200222220002222202000002002000022
002200222220000000000020000222000000000002000000002000000020000000002200220200002222200000200000000002
002200222220000002202000000222000000220200000020200000220200000202000000000000000000022020000002020002
002200222220000222222000200222000022222200020022200020222200200222000000000000000000022220002002220002
002200222220200222222000000222020022222200000022200000222200000222002222222200222222222220000002220002
002200222222222222222200000222222222222220000022220000222200000222202222222220222222222222000002222002
002200222222222222222200000222222222222220000022220000222200000222200200000200200000222222000002222002
002200222222222222222220000222222222222222000022222000222220000222200000020000000020022222200002222002
000200022000000222000000000200000022200000000000000000200000000000002202000000202000020000000000000000
000000000000000222000000000000000022200000000000000000200000000000002222000200222000220000000000000000
022202222220000000200000200222000000020000020020000020020000200200002222000000222000002000002002000022
002200222220000000000020000222000000000002000000002000000020000000002222200000222200000000200000000002
002200222220000002202000000222000000220200000020200000220200000202002222200000222200022020000002020002
002200222220000222222000200222000022222200020000222220222200200002202222220000222220022220002000022002
000000000200000000000000000020000000000000000000000200000000000000000000000000000000000000000000000000
000000000020000000000000000002000000000000000000000020000000000000000000000000000000000000000000000000
002200222220000000000000000222000000000000000000222220000000000002200000000000000000000000000000022002
002200222220000222200220000222000022220022000000222220220020000002200000022220022000022002200000022002
002200222220000222200220000222000022220022000000222220220020000002200000022220022000022002200000022002
002200222220000222200222220222000022220022222000222220220022220002202000022220022222022002222200022002
002200222222000222200220200222200022220022020000222222220020200002200000022220022020022002202000022002
002200222222000000000000000222200000000000000000222222000000000002200000000000000000000000000000022002
002200222220000000000000000222000000000000000000222220000000000002200000000000000000000000000000022002
002200222220000222222222200222000022222222220000222220222222200002200000022222222220022222222000022002
000002000002002220000000200000200200000200002222000000000200022220020000222200220000000020000222200000
000000000200002220000000000020000000020000002222200000020000022222020000222200222220002000000222220000
000022020000002220000002202000000202000000002222200000000000022222020000222200220200000000000222220000
002222220002002220000222222000200002222200022222220000222200222222220000000000000020022220002222222002
002222220000002220200222222000000002222200022000000000222200220000000000000000000002022220002200000002
022222222000002222222222222200000002222220022000000000222200220000000000000000022222022222002200000022
022202222220002222222222220222000222222222222022222222222222220222202200220000002222222222222202222022
022202222220000000200000200222000000020000020020000020020000200200002200222220002222202000002002000022
